R         1370 700

NO ./tpics/colorstone.xpm
SO ./tpics/greystone.xpm
WE ./tpics/mossy.xpm
EA ./tpics/redbrick.xpm

S ./tpics/guard.xpm
F 168,102,50
C 52,171,235

        1111111111111111111111111
        1000000000110000000000001
        1011000001110000002000001
        1001000000000020000000001
111111111011000001110000000000001
100000000011000001110111110111111
11110111111111011100000010001
11110111111111011101010010001
11000000110101011100000010001
10000200000000001100000010001
10000000000000001101010010001
11000001110101011111011110N0111
11110111 1110101 101111010001
11111111 1111111 111111111111
