R 700 500
NO ./path_to_the_north_texture
SO ./path_to_the_south_texture
WE ./path_to_the_west_texture
EA ./path_to_the_east_texture
S ./path_to_the_sprite_texture
F 220,100,0 
C 225,30,0

111111111111111111111111111111111111111111111111111111111111111111111111111111111
100000000000000000000000000000000000000000000000000000000000000000000000000000001
100000000000000000000000000000000000000000000000000000000000000000000000000111111
1000N00000000000000000000000000000000000000000000000000000000000000000000000000011
10000000000000000000000000000000000000000000000000000000000000000000000000000000011
1000000000000000000000000000000000000000000000000000000000000000000000000000000001
1000000000000000000000000000000000000000000000000000000000000000000000000000000001
1111111111000000000000000000000000000000000000000000000000111111111110000000000011
1111000000000000000000000000000000000011111111111111111100000000000010000000000011
1110000000000000000000000000000000000000000000000000011100000000000010000000000011
1100000000000000000000000000000000000000000000000000011111110000000010000000000001
1000000000000000000000000000000000000000000000000000000000010000000010000000000001
1000000000000000000000000000000000000000000000000000011111110000000010000000000011
1000000000000000000000000000000000000000000000000000010000000000000110000000000011
1000000000000000000000000000000000000000000000000000010000000000000010000000000011
10000000000000000000000000000000000000000000000000000111111111111111100000000000011
1000000000000000000000000000000000000000000000000000000000000000000000000000000001
1000000000000000000000000000000000000000000000000000000000000000000000000000000001
1100000000000000000000000000000000000000000000000000000000000000000000000000000001
10000000000000000000000000000000000000000000000000000000000000000000000000000000011
11111111111111111111111111111111111111111111111111111111111111111111111111111111111

