R 700 500
NO ./path_to_the_north_texture
SO ./path_to_the_south_texture
WE ./path_to_the_west_texture
EA ./path_to_the_east_texture
S ./path_to_the_sprite_texture
F 220,100,0 
C 225,30,0

      111111111111111111111
111111100000000000000000001
100000000000000000011110001
100011111111000000000010001
100000001000000001000010001
111111111000000000000010001
100000001000000001111111111
100000001000000000000000001
100000000000000000000000001
100000000001000011111110001
111110000000100010000010001
1000100000N0000010010010001
100010000000000000000010001
100000000000000000000010001
100000000000000010000010001
100111110000100010000010001
100000010000000011111110001
100000010000000000000000001
111111111111111111111111111
