R           1200          900

NO ./tpics/colorstone.xpm
SO ./tpics/greystone.xpm
WE ./tpics/mossy.xpm
EA ./tpics/redbrick.xpm

S ./path_to_the_sprite_texture
F 220,100,0
C 225,30,0


11111111
11000111
10N01111
100010
1111111