R 2560 1440
NO ./path_to_the_north_texture
SO ./path_to_the_south_texture
WE ./path_to_the_west_texture
EA ./path_to_the_east_texture

S ./path_to_the_sprite_texture
F 220,100,0
C 225,30,0

        1111111111111111111111111
        1000000000110000000000001
        1011000001110000000000001
        1001000000000000000000001
111111111011000001110000000000001
100000000011000001110111110111111
1111011111111101110000001000111
1111011111111101110101001000111
1100000011010101110000001000111
1000200000000000110000001000111
1000000000000001111101001000111
1100000111010101 111011110N0111
11110111 1110101 10111101000111
11111111 1111111 11111111111111